
ACID = Atomicity, Consistency, Isolation, Durability
API  = Application Programming Interfaces
AJAX = Asynchronous Javascript and XML 
AWS  = Amazon Web Services 

BSON = Binary JSON 

CD   = continuous delivery 
CDN  = Content Delivery Network 
CI   = continuous integration
CLS  = Cumulative Layout Shift
CMS  = Content management system 
CORS = 
CRUD = CREATE, READ, UPDATE, DELETE
CSR  = Client Side Rendering
CSS  = Cascading Style Sheets 



DOM  = Document Object Model 
DRY  = Don't Repeat Yourself 

GUI  = graphical user interface 

HOC  = Higher Order Components
HOC  = Higher Order Functions 
HTML = Hyper Text Markup Language 


IIFE = Immediately Invoked Function Expression 
IoT  = Internet of Things 
ISR  = Incremental Static Regeneration



JSON = Javascript Object Notation 


LCP  = Largest Contentful Paint 
LTS  = Long Term Support 



MQL  = MongoDB Query Language 
MVC  = Model View Controller
MVVC = Multi Version Concurrency Control 


NPM  = Node Package Manager 

PIP  = Python Package Installer 

RBAC = Role based access control
RDF  = Resource Description Framework 

SASS = 
SEO  = Search Engine Optimization
SPA  = Single Page Application 
SQL  = Structured Query Language 
SSG  = Static Site Generation 
SSL  = 
SSR  = Server Side Rendering
SWR  = Stale While Revalidating

TLS  = 
TTFB = time to the first byte 

UDFs = User Defined Functions 
XSS  = Cross site scripting





